

NO textures/N.xpm
SO textures/S.xpm
WE textures/W.xpm
EA textures/E.xpm

F 155,100,83
C 135,200,235



111111
000101
100001
1100N1
111111
