NO textures/N.xpm
SO textures/S.xpm
WE textures/W.xpm
EA textures/E.xpm

F 155,100,83
C 135,200,235

1111111111111111111111111
1S10000000110000000000001
1100000000110000000000001
1000000000110000000000001
1000000000110000000000001
1111111111111111111111111
