NO textures/N.xpm
SO textures/S.xpm
WE textures/W.xpm
EA textures/E.xpm

F 155,100,83
C 135,200,235


1111111111111111111111111
1N00000000110000000000001
1011000001110000000000001
100100000000000000000000111111111
111111111011000001110000000000100
100000000011000001110111111011111
11110111111111011100000010001
11110111111111011101010010001
11000000110101011100000010001
10000000000000001100000010001
10000000000000001101010010001
1100000111010101111101111000111
11110111 1110101 101111010001
11111111 1111111 111111111111
